date,1,2,3,4,5,6,total
2017-01-31,12,10,18,8,19,5,72
2017-02-01,20,11,11,18,16,14,90
2017-02-02,10,1,11,12,10,20,64
2017-02-03,20,6,1,15,1,8,51
2017-02-04,15,15,5,1,6,11,53
2017-02-05,20,17,8,13,6,5,69
2017-02-06,18,17,7,17,9,14,82
2017-02-07,6,19,8,14,12,9,68
2017-02-08,9,19,12,10,6,8,64
2017-02-09,7,4,6,7,8,19,51
2017-02-10,10,17,12,1,3,6,49
2017-02-11,6,13,18,20,3,16,76
2017-02-12,12,5,9,10,9,15,60
2017-02-13,9,9,6,3,10,19,56
2017-02-14,2,14,14,3,13,2,48
2017-02-15,13,16,12,4,10,15,70
2017-02-16,19,4,14,4,13,17,71
2017-02-17,20,16,13,8,19,2,78
2017-02-18,9,8,2,3,14,14,50
2017-02-19,6,12,15,17,1,18,69
2017-02-20,5,16,8,9,18,9,65
2017-02-21,16,4,9,8,15,17,69
2017-02-22,20,12,2,19,6,10,69
2017-02-23,16,16,7,1,4,13,57
2017-02-24,19,18,15,4,8,5,69
2017-02-25,13,1,15,19,19,14,81
2017-02-26,14,5,13,10,3,6,51
2017-02-27,4,1,15,9,14,15,58
2017-02-28,13,7,12,13,3,19,67
2017-03-01,2,16,15,6,11,19,69
2017-03-02,18,15,14,5,11,18,81
2017-03-03,16,11,10,14,7,17,75
2017-03-04,6,16,9,12,2,5,50
2017-03-05,6,2,17,7,20,17,69
2017-03-06,2,6,7,15,17,8,55
2017-03-07,9,12,18,18,12,11,80
2017-03-08,16,10,6,11,16,20,79
2017-03-09,1,2,2,18,10,16,49
2017-03-10,16,9,14,6,8,3,56
2017-03-11,13,19,11,11,17,17,88
2017-03-12,12,16,9,17,4,15,73
2017-03-13,2,17,9,3,15,2,48
2017-03-14,13,20,3,4,20,11,71
2017-03-15,12,2,13,18,11,6,62
2017-03-16,4,13,10,5,18,4,54
2017-03-17,3,4,15,16,3,13,54
2017-03-18,6,8,16,6,12,17,65
2017-03-19,3,18,12,6,15,6,60
2017-03-20,14,6,17,14,1,11,63
2017-03-21,2,12,19,11,14,18,76
2017-03-22,11,17,12,12,14,4,70
2017-03-23,2,11,10,12,11,5,51
2017-03-24,1,18,14,6,9,20,68
2017-03-25,17,14,6,11,12,17,77
2017-03-26,19,9,6,3,16,17,70
2017-03-27,2,1,9,10,18,2,42
2017-03-28,13,14,19,18,15,11,90
2017-03-29,4,12,14,5,12,5,52
2017-03-30,6,13,19,13,1,5,57
2017-03-31,8,20,12,8,8,6,62
2017-04-01,10,6,18,14,9,18,75
2017-04-02,14,8,14,13,2,7,58
2017-04-03,13,14,17,16,20,19,99
2017-04-04,7,19,11,8,16,19,80
2017-04-05,7,6,4,13,18,10,58
2017-04-06,9,18,18,11,14,19,89
2017-04-07,8,4,11,16,1,3,43
2017-04-08,3,3,5,11,3,7,32
2017-04-09,11,3,1,15,7,2,39
2017-04-10,13,2,3,2,11,11,42
2017-04-11,12,12,5,7,7,14,57
2017-04-12,17,10,15,4,19,6,71
2017-04-13,2,12,20,15,7,2,58
2017-04-14,11,9,10,17,1,20,68
2017-04-15,16,14,13,17,14,14,88
2017-04-16,16,7,19,16,6,16,80
2017-04-17,8,19,10,3,15,20,75
2017-04-18,17,12,15,12,12,10,78
2017-04-19,10,14,5,16,12,7,64
2017-04-20,6,1,14,4,4,15,44
2017-04-21,2,18,4,19,5,4,52
2017-04-22,8,14,8,19,8,7,64
2017-04-23,5,13,4,11,8,1,42
2017-04-24,6,12,10,12,1,17,58
2017-04-25,2,19,13,15,8,20,77
2017-04-26,2,7,3,11,7,10,40
2017-04-27,4,7,8,2,3,18,42
2017-04-28,7,19,14,7,14,1,62
2017-04-29,13,14,16,20,4,17,84
2017-04-30,12,2,7,14,6,15,56
2017-05-01,4,7,19,17,11,13,71
2017-05-02,15,17,9,2,9,2,54
2017-05-03,8,15,6,6,6,6,47
2017-05-04,5,13,7,16,13,5,59
2017-05-05,6,7,6,9,1,16,45
2017-05-06,9,8,1,17,16,19,70
2017-05-07,2,8,13,14,3,19,59
2017-05-08,2,12,19,15,14,4,66
2017-05-09,10,17,11,16,17,15,86
2017-05-10,13,18,20,3,3,2,59
2017-05-11,14,3,14,9,3,15,58
2017-05-12,12,4,10,19,15,9,69
2017-05-13,5,11,7,11,13,15,62
2017-05-14,9,3,15,5,18,19,69
2017-05-15,5,18,10,12,17,12,74
2017-05-16,11,11,7,10,1,8,48
2017-05-17,5,4,3,17,5,13,47
2017-05-18,3,16,18,15,13,9,74
2017-05-19,12,19,20,20,15,13,99
2017-05-20,7,4,2,15,14,19,61
2017-05-21,15,10,14,9,13,14,75
2017-05-22,20,10,19,13,19,5,86
2017-05-23,20,16,20,20,10,6,92
2017-05-24,11,16,8,7,11,19,72
2017-05-25,7,20,2,3,7,18,57
2017-05-26,3,1,6,19,8,17,54
2017-05-27,7,4,19,11,17,2,60
2017-05-28,2,1,18,10,7,8,46
2017-05-29,18,20,9,17,11,1,76
2017-05-30,4,7,15,3,13,2,44
2017-05-31,18,16,5,9,19,18,85
2017-06-01,4,4,15,7,18,3,51
2017-06-02,12,4,18,11,14,20,79
2017-06-03,18,7,12,9,2,14,62
2017-06-04,16,9,6,18,4,6,59
2017-06-05,20,9,4,19,16,18,86
2017-06-06,2,3,20,13,8,11,57
2017-06-07,14,9,14,18,13,6,74
2017-06-08,13,12,8,19,8,2,62
2017-06-09,6,1,20,2,2,18,49
2017-06-10,9,9,8,10,11,10,57
2017-06-11,15,5,6,10,4,10,50
2017-06-12,19,17,12,11,20,12,91
2017-06-13,3,13,5,3,16,4,44
2017-06-14,10,1,1,3,5,13,33
2017-06-15,13,13,19,20,13,3,81
2017-06-16,11,8,5,6,19,20,69
2017-06-17,8,2,6,16,1,6,39
2017-06-18,8,6,19,8,19,2,62
2017-06-19,11,5,7,11,5,15,54
2017-06-20,19,19,16,16,16,11,97
2017-06-21,20,18,19,3,16,9,85
2017-06-22,17,5,1,19,10,12,64
2017-06-23,8,16,18,3,18,6,69
2017-06-24,8,4,1,10,3,14,40
2017-06-25,9,8,12,1,15,6,51
2017-06-26,6,9,16,11,8,14,64
2017-06-27,3,9,7,13,1,10,43
2017-06-28,5,17,15,12,3,16,68
2017-06-29,7,18,17,1,1,8,52
2017-06-30,5,10,12,5,4,16,52
2017-07-01,13,17,10,8,14,6,68
2017-07-02,20,7,1,9,7,13,57
2017-07-03,9,2,2,1,14,6,34
2017-07-04,5,19,18,4,14,19,79
2017-07-05,2,7,16,2,5,16,48
2017-07-06,15,1,5,1,5,2,29
2017-07-07,13,17,17,4,4,19,74
2017-07-08,17,12,8,5,3,4,49
2017-07-09,6,3,14,15,13,6,57
2017-07-10,18,19,2,4,20,9,72
2017-07-11,18,15,17,20,3,10,83
2017-07-12,1,12,17,16,13,3,62
2017-07-13,9,14,11,20,2,5,61
2017-07-14,5,10,16,3,9,13,56
2017-07-15,11,9,20,11,10,10,71
2017-07-16,2,8,5,19,1,16,51
2017-07-17,3,16,6,9,12,16,62
2017-07-18,12,14,12,10,1,9,58
2017-07-19,5,14,16,19,5,8,67
2017-07-20,9,10,2,12,12,10,55
2017-07-21,9,17,2,6,13,17,64
2017-07-22,11,20,10,5,20,2,68
2017-07-23,12,16,17,5,11,17,78
2017-07-24,6,7,4,18,4,10,49
2017-07-25,19,3,17,13,17,6,75
2017-07-26,8,1,1,14,7,1,32
2017-07-27,12,9,16,10,20,16,83
2017-07-28,1,17,20,17,3,7,65
2017-07-29,2,4,18,6,10,20,60
2017-07-30,2,4,6,10,18,8,48
2017-07-31,14,14,5,13,7,4,57
2017-08-01,19,1,17,9,19,16,81
2017-08-02,20,7,9,5,9,9,59
2017-08-03,18,18,11,5,9,6,67
2017-08-04,6,7,15,10,7,2,47
2017-08-05,3,3,6,8,18,17,55
2017-08-06,11,20,15,17,12,16,91
2017-08-07,3,4,5,18,8,17,55
2017-08-08,2,18,15,11,3,15,64
2017-08-09,12,20,15,13,2,18,80
2017-08-10,9,5,2,5,3,4,28
2017-08-11,5,19,9,20,14,16,83
2017-08-12,14,14,6,2,10,3,49
2017-08-13,4,12,4,16,19,14,69
2017-08-14,18,13,20,8,17,7,83
2017-08-15,6,7,10,5,1,7,36
2017-08-16,13,10,1,11,14,13,62
2017-08-17,19,9,10,20,5,18,81
2017-08-18,19,12,10,6,15,2,64
2017-08-19,1,2,10,3,2,5,23
2017-08-20,1,12,16,6,5,2,42
2017-08-21,20,18,19,14,6,11,88
2017-08-22,4,7,18,6,3,1,39
2017-08-23,19,19,8,10,10,14,80
2017-08-24,3,13,9,11,6,10,52
2017-08-25,9,19,5,17,20,9,79
2017-08-26,16,8,20,16,8,3,71
2017-08-27,14,20,8,4,17,9,72
2017-08-28,8,3,19,14,17,13,74
2017-08-29,12,11,3,4,12,12,54
2017-08-30,14,3,3,18,20,1,59
2017-08-31,7,13,3,11,2,2,38
2017-09-01,14,6,11,1,20,7,59
2017-09-02,18,6,11,10,16,20,81
2017-09-03,4,17,10,11,1,15,58
2017-09-04,19,15,9,8,20,16,87
2017-09-05,13,1,12,11,7,19,63
2017-09-06,6,5,17,13,1,14,56
2017-09-07,1,7,3,13,11,17,52
2017-09-08,5,6,2,19,5,7,44
2017-09-09,16,19,13,7,13,6,74
2017-09-10,19,11,9,18,12,2,71
2017-09-11,5,15,2,18,12,4,56
2017-09-12,2,9,17,5,1,20,54
2017-09-13,3,1,10,13,16,2,45
2017-09-14,1,7,5,4,18,19,54
2017-09-15,7,5,20,20,12,9,73
2017-09-16,4,16,6,9,12,7,54
2017-09-17,12,10,12,2,16,10,62
2017-09-18,4,2,7,3,15,11,42
2017-09-19,20,5,10,14,20,7,76
2017-09-20,7,2,16,12,1,20,58
2017-09-21,4,19,1,3,11,17,55
2017-09-22,6,5,13,1,2,20,47
2017-09-23,19,11,18,11,20,10,89
2017-09-24,8,10,16,1,10,10,55
2017-09-25,6,4,12,3,2,17,44
2017-09-26,18,18,15,6,2,7,66
2017-09-27,6,15,16,20,15,1,73
2017-09-28,15,5,4,1,8,9,42
2017-09-29,17,8,11,4,15,4,59
2017-09-30,20,14,1,19,19,10,83
2017-10-01,4,17,8,8,9,11,57
2017-10-02,17,19,11,16,17,18,98
2017-10-03,20,1,9,3,11,4,48
2017-10-04,17,1,7,2,4,6,37
2017-10-05,19,8,12,8,18,13,78
2017-10-06,17,13,1,11,8,19,69
2017-10-07,14,9,10,6,18,1,58
2017-10-08,7,12,18,3,11,5,56
2017-10-09,13,12,19,11,17,11,83
2017-10-10,11,3,12,7,2,17,52
2017-10-11,8,18,1,6,3,5,41
2017-10-12,3,19,10,3,5,20,60
2017-10-13,1,20,3,20,11,8,63
2017-10-14,13,15,2,2,9,3,44
2017-10-15,13,3,3,10,4,9,42
2017-10-16,7,2,1,17,20,18,65
2017-10-17,5,6,11,19,12,16,69
2017-10-18,16,12,10,8,17,2,65
2017-10-19,6,12,20,2,13,16,69
2017-10-20,3,16,10,4,9,18,60
2017-10-21,15,9,9,7,17,5,62
2017-10-22,11,20,4,3,2,2,42
2017-10-23,6,11,5,16,10,4,52
2017-10-24,11,14,3,12,13,20,73
2017-10-25,10,9,11,14,3,9,56
2017-10-26,4,8,10,15,9,19,65
2017-10-27,20,12,6,12,6,8,64
2017-10-28,19,17,18,9,3,5,71
2017-10-29,7,6,18,3,3,19,56
2017-10-30,8,10,10,13,19,5,65
2017-10-31,5,14,13,6,19,12,69
2017-11-01,8,19,19,12,1,20,79
2017-11-02,13,4,9,10,16,4,56
2017-11-03,6,7,16,7,9,11,56
2017-11-04,1,1,12,8,14,7,43
2017-11-05,20,14,2,9,6,4,55
2017-11-06,8,1,11,7,13,15,55
2017-11-07,9,11,3,10,7,10,50
2017-11-08,15,15,4,11,14,8,67
2017-11-09,17,19,12,20,3,8,79
2017-11-10,1,2,14,11,12,16,56
2017-11-11,5,1,2,18,8,9,43
2017-11-12,5,18,20,13,2,4,62
2017-11-13,7,9,3,4,13,12,48
2017-11-14,7,4,4,3,16,13,47
2017-11-15,10,9,9,8,7,15,58
2017-11-16,1,7,11,6,17,5,47
2017-11-17,15,13,9,13,10,16,76
2017-11-18,14,5,17,12,11,4,63
2017-11-19,18,8,11,13,11,3,64
2017-11-20,12,8,15,12,6,15,68
2017-11-21,16,8,17,18,19,12,90
2017-11-22,10,17,14,10,9,10,70
2017-11-23,4,3,11,12,12,10,52
2017-11-24,13,13,13,10,2,5,56
2017-11-25,12,14,14,6,1,10,57
2017-11-26,8,15,10,7,4,4,48
2017-11-27,16,8,7,10,2,8,51
2017-11-28,17,19,5,9,5,9,64
2017-11-29,11,1,17,19,4,17,69
2017-11-30,12,8,18,18,12,6,74
2017-12-01,6,5,15,7,1,19,53
2017-12-02,8,15,14,12,15,20,84
2017-12-03,1,10,4,5,6,14,40
2017-12-04,19,6,3,18,17,18,81
2017-12-05,11,16,10,5,15,10,67
2017-12-06,13,8,14,3,20,3,61
2017-12-07,4,15,10,2,4,7,42
2017-12-08,17,18,10,17,17,2,81
2017-12-09,13,17,5,1,3,2,41
2017-12-10,1,11,13,11,18,4,58
2017-12-11,20,17,19,1,11,11,79
2017-12-12,18,5,15,11,6,20,75
2017-12-13,3,8,14,5,6,4,40
2017-12-14,16,19,12,15,2,16,80
2017-12-15,13,14,6,3,17,6,59
2017-12-16,13,11,6,6,12,4,52
2017-12-17,5,3,17,12,12,4,53
2017-12-18,8,11,19,12,10,12,72
2017-12-19,19,14,4,18,3,8,66
2017-12-20,14,6,9,10,20,8,67
2017-12-21,16,10,3,13,18,12,72
2017-12-22,15,10,10,1,20,1,57
2017-12-23,13,13,3,4,14,2,49
2017-12-24,16,6,4,13,19,5,63
2017-12-25,2,10,5,12,5,1,35
2017-12-26,16,1,13,12,20,17,79
2017-12-27,10,12,14,17,12,8,73
2017-12-28,1,3,7,10,20,5,46
2017-12-29,4,4,2,10,12,17,49
2017-12-30,9,2,5,2,8,20,46
2017-12-31,14,4,10,6,20,17,71
2018-01-01,4,6,1,20,2,10,43
2018-01-02,5,16,20,3,7,18,69
2018-01-03,3,4,11,2,3,13,36
2018-01-04,5,3,8,19,14,3,52
2018-01-05,4,5,14,17,6,6,52
2018-01-06,2,6,16,8,9,13,54
2018-01-07,3,2,20,2,17,9,53
2018-01-08,2,6,7,1,12,12,40
2018-01-09,19,10,5,5,18,3,60
2018-01-10,6,11,3,3,19,7,49
2018-01-11,9,17,9,9,3,4,51
2018-01-12,3,3,9,1,16,3,35
2018-01-13,20,1,19,3,10,18,71
2018-01-14,11,16,1,20,5,15,68
2018-01-15,9,20,8,16,1,9,63
2018-01-16,5,2,13,14,2,5,41
2018-01-17,6,1,2,9,13,18,49
2018-01-18,8,1,8,4,4,20,45
2018-01-19,7,10,19,16,18,13,83
2018-01-20,1,9,10,16,15,8,59
2018-01-21,1,5,2,7,18,17,50
2018-01-22,10,1,11,19,1,5,47
2018-01-23,2,3,14,15,5,18,57
2018-01-24,5,16,17,9,17,17,81
2018-01-25,20,11,7,19,19,10,86
2018-01-26,17,18,14,20,1,9,79
2018-01-27,13,13,19,4,13,6,68
2018-01-28,3,18,8,9,7,11,56
2018-01-29,10,3,10,7,12,7,49
2018-01-30,2,10,12,16,8,5,53
2018-01-31,10,15,7,1,8,18,59
2018-02-01,9,1,10,20,19,4,63
2018-02-02,17,16,5,5,13,20,76
2018-02-03,11,2,2,10,5,5,35
2018-02-04,17,9,9,3,16,14,68
2018-02-05,19,14,5,12,1,15,66
2018-02-06,13,8,11,13,11,14,70
2018-02-07,7,5,2,15,16,19,64
2018-02-08,9,10,19,15,3,11,67
2018-02-09,13,20,14,2,2,7,58
2018-02-10,19,5,8,5,2,12,51
2018-02-11,5,5,18,2,7,12,49
2018-02-12,4,20,4,10,1,16,55
2018-02-13,14,7,18,7,10,3,59
2018-02-14,18,1,14,8,2,19,62
2018-02-15,2,12,20,6,1,17,58
2018-02-16,9,11,15,7,4,10,56
2018-02-17,11,5,16,15,10,13,70
2018-02-18,3,9,9,7,4,19,51
2018-02-19,18,1,15,20,7,3,64
2018-02-20,5,7,4,3,20,2,41
2018-02-21,3,8,13,9,3,13,49
2018-02-22,10,7,2,15,16,8,58
2018-02-23,17,7,19,10,5,1,59
2018-02-24,19,1,17,4,2,14,57
2018-02-25,4,8,9,9,16,2,48
2018-02-26,10,20,3,16,17,18,84
2018-02-27,18,14,13,20,12,11,88
2018-02-28,20,6,3,14,4,9,56
2018-03-01,7,17,5,17,19,10,75
2018-03-02,15,7,15,6,19,2,64
2018-03-03,4,17,18,19,8,10,76
2018-03-04,5,14,17,5,15,16,72
2018-03-05,16,20,13,13,9,10,81
2018-03-06,12,20,13,5,5,13,68
2018-03-07,1,10,10,8,2,7,38
2018-03-08,9,18,4,19,15,4,69
2018-03-09,11,10,14,2,19,2,58
2018-03-10,4,6,14,9,12,8,53
2018-03-11,19,1,10,5,2,5,42
2018-03-12,9,5,19,17,13,15,78
2018-03-13,13,13,16,9,8,13,72
2018-03-14,8,4,20,18,13,20,83
2018-03-15,18,20,12,16,4,1,71
2018-03-16,16,6,11,20,6,3,62
2018-03-17,17,18,20,20,3,14,92
2018-03-18,20,7,7,6,13,17,70
2018-03-19,13,15,9,15,13,5,70
2018-03-20,4,1,9,4,6,18,42
2018-03-21,1,20,5,20,7,16,69
2018-03-22,17,6,10,5,7,16,61
2018-03-23,20,17,13,8,19,20,97
2018-03-24,8,6,15,3,16,16,64
2018-03-25,13,3,11,13,4,13,57
2018-03-26,3,11,13,6,20,10,63
2018-03-27,10,20,4,6,14,7,61
2018-03-28,13,10,3,7,14,14,61
2018-03-29,8,13,10,19,5,20,75
2018-03-30,14,20,17,8,19,14,92
2018-03-31,6,14,10,10,11,12,63
2018-04-01,13,14,11,11,7,15,71
2018-04-02,11,12,16,8,10,13,70
2018-04-03,7,16,9,1,14,7,54
2018-04-04,3,5,20,18,15,18,79
2018-04-05,12,19,11,20,2,2,66
2018-04-06,18,7,10,20,5,7,67
2018-04-07,9,14,16,12,12,18,81
2018-04-08,12,7,2,4,8,19,52
2018-04-09,14,20,8,3,9,19,73
2018-04-10,7,14,5,4,12,5,47
2018-04-11,14,11,3,6,18,6,58
2018-04-12,10,18,19,3,7,3,60
2018-04-13,1,14,1,19,6,14,55
2018-04-14,19,17,1,3,20,17,77
2018-04-15,11,12,4,18,8,17,70
2018-04-16,8,19,9,20,4,12,72
2018-04-17,1,3,12,8,18,18,60
2018-04-18,9,9,3,15,12,9,57
2018-04-19,15,10,6,16,14,13,74
2018-04-20,2,18,11,2,1,15,49
2018-04-21,20,11,19,1,14,11,76
2018-04-22,12,16,2,8,9,17,64
2018-04-23,5,6,10,8,19,18,66
2018-04-24,4,14,19,16,7,20,80
2018-04-25,5,10,14,20,10,10,69
2018-04-26,15,9,10,6,18,1,59
2018-04-27,6,16,5,11,5,14,57
2018-04-28,14,16,15,17,19,15,96
2018-04-29,8,1,9,5,7,20,50
2018-04-30,12,10,3,7,18,5,55
2018-05-01,18,17,17,17,19,16,104
2018-05-02,15,8,5,15,16,16,75
2018-05-03,2,1,6,14,2,4,29
2018-05-04,16,6,14,15,12,18,81
2018-05-05,18,6,18,19,20,16,97
2018-05-06,10,13,2,2,12,6,45
2018-05-07,14,8,12,17,15,7,73
2018-05-08,9,18,10,13,12,17,79
2018-05-09,3,11,17,1,13,14,59
2018-05-10,17,14,13,16,7,2,69
2018-05-11,14,5,4,13,14,12,62
2018-05-12,6,12,17,14,13,5,67
2018-05-13,20,15,15,4,11,7,72
2018-05-14,9,20,20,18,15,15,97
2018-05-15,4,19,5,15,8,13,64
2018-05-16,20,5,12,18,5,15,75
2018-05-17,15,2,8,20,2,19,66
2018-05-18,7,2,19,18,16,19,81
2018-05-19,8,14,3,6,17,2,50
2018-05-20,6,11,17,14,20,13,81
2018-05-21,15,8,14,17,15,3,72
2018-05-22,19,6,12,8,6,12,63
2018-05-23,7,3,7,9,6,8,40
2018-05-24,12,17,17,12,18,20,96
2018-05-25,14,4,8,15,20,5,66
2018-05-26,14,12,15,11,11,2,65
2018-05-27,15,3,6,9,7,11,51
2018-05-28,4,5,14,10,13,1,47
2018-05-29,12,9,6,6,3,6,42
2018-05-30,1,15,20,10,17,10,73
2018-05-31,10,9,3,9,8,6,45
2018-06-01,6,18,11,7,14,13,69
2018-06-02,7,10,13,3,9,16,58
2018-06-03,20,19,8,13,20,15,95
2018-06-04,6,16,18,13,17,12,82
2018-06-05,13,3,17,17,6,4,60
2018-06-06,20,13,20,8,3,17,81
2018-06-07,16,20,19,7,1,5,68
2018-06-08,8,7,4,2,6,4,31
2018-06-09,2,7,18,11,9,7,54
2018-06-10,11,8,17,1,13,20,70
2018-06-11,6,6,11,16,8,8,55
2018-06-12,2,15,19,16,4,6,62
2018-06-13,18,13,15,11,14,14,85
2018-06-14,13,15,12,10,14,2,66
2018-06-15,3,17,8,3,11,3,45
2018-06-16,17,17,19,7,9,3,72
2018-06-17,13,8,1,11,4,19,56
2018-06-18,3,1,4,8,14,15,45
2018-06-19,2,12,14,12,3,4,47
2018-06-20,1,2,5,8,3,10,29
2018-06-21,8,6,14,7,4,4,43
2018-06-22,16,9,5,9,18,12,69
2018-06-23,12,17,4,7,9,5,54
2018-06-24,12,12,7,16,9,2,58
2018-06-25,20,3,14,10,9,20,76
2018-06-26,20,3,6,11,20,3,63
2018-06-27,1,11,3,12,15,13,55
2018-06-28,14,20,15,10,7,1,67
2018-06-29,7,14,15,12,15,16,79
2018-06-30,19,12,11,16,5,14,77
2018-07-01,11,12,8,9,6,3,49
2018-07-02,17,17,8,2,3,4,51
2018-07-03,10,14,6,20,15,13,78
2018-07-04,20,9,1,15,7,17,69
2018-07-05,19,8,7,9,15,16,74
2018-07-06,5,18,16,13,17,16,85
2018-07-07,11,13,7,16,15,4,66
2018-07-08,2,15,12,12,12,10,63
2018-07-09,6,6,5,7,4,8,36
2018-07-10,10,17,11,12,10,8,68
2018-07-11,1,2,12,8,15,14,52
2018-07-12,17,15,14,6,2,19,73
2018-07-13,13,10,6,2,18,11,60
2018-07-14,2,3,10,8,7,16,46
2018-07-15,19,14,19,2,8,12,74
2018-07-16,5,3,18,14,17,16,73
2018-07-17,4,7,14,13,5,2,45
2018-07-18,1,10,9,2,13,12,47
2018-07-19,2,14,10,16,8,7,57
2018-07-20,8,7,18,6,16,17,72
2018-07-21,6,10,9,19,6,19,69
2018-07-22,18,19,7,19,17,3,83
2018-07-23,5,14,8,7,12,19,65
2018-07-24,16,3,6,13,14,8,60
2018-07-25,4,7,10,10,6,19,56
2018-07-26,17,7,20,18,20,16,98
2018-07-27,16,4,12,3,6,4,45
2018-07-28,5,20,10,15,19,15,84
2018-07-29,8,1,16,12,11,6,54
2018-07-30,15,13,4,18,2,16,68
2018-07-31,10,11,11,12,17,7,68
2018-08-01,19,6,4,6,9,2,46
2018-08-02,2,4,4,3,7,15,35
2018-08-03,1,12,4,20,15,13,65
2018-08-04,13,11,10,6,12,5,57
2018-08-05,16,11,2,14,13,5,61
2018-08-06,12,14,4,1,9,16,56
2018-08-07,10,20,18,15,14,13,90
2018-08-08,3,5,16,2,11,11,48
2018-08-09,15,8,9,4,12,16,64
2018-08-10,17,3,2,12,4,15,53
2018-08-11,17,6,15,16,17,14,85
2018-08-12,11,19,17,10,14,2,73
2018-08-13,5,6,2,17,5,12,47
2018-08-14,16,19,20,20,18,12,105
2018-08-15,16,16,9,1,14,10,66
2018-08-16,7,12,13,10,13,8,63
2018-08-17,12,19,10,15,11,16,83
2018-08-18,3,16,15,7,3,10,54
2018-08-19,16,11,11,12,6,14,70
2018-08-20,5,12,20,20,7,2,66
2018-08-21,19,3,15,16,15,17,85
2018-08-22,13,2,11,6,9,17,58
2018-08-23,4,20,16,6,12,16,74
2018-08-24,9,2,1,13,18,17,60
2018-08-25,1,19,15,14,4,13,66
2018-08-26,17,6,19,15,8,10,75
2018-08-27,16,15,2,18,8,12,71
2018-08-28,12,16,13,9,6,5,61
2018-08-29,13,16,10,16,3,2,60
2018-08-30,1,13,7,5,2,3,31
2018-08-31,11,13,11,5,4,14,58
2018-09-01,17,14,19,7,9,2,68
2018-09-02,13,3,9,18,16,6,65
2018-09-03,10,18,11,4,14,4,61
2018-09-04,1,4,16,1,4,18,44
2018-09-05,4,16,9,6,17,13,65
2018-09-06,11,19,2,10,19,12,73
2018-09-07,1,13,16,17,2,10,59
2018-09-08,4,13,17,19,20,8,81
2018-09-09,16,10,9,6,17,17,75
2018-09-10,5,2,10,5,17,11,50
2018-09-11,15,13,17,19,10,3,77
2018-09-12,9,2,1,19,5,6,42
2018-09-13,12,7,2,16,8,1,46
2018-09-14,17,19,12,16,11,11,86
2018-09-15,18,12,20,17,9,15,91
2018-09-16,1,7,10,7,16,11,52
2018-09-17,14,11,7,4,2,17,55
2018-09-18,13,18,17,10,19,20,97
2018-09-19,11,8,19,1,20,16,75
2018-09-20,15,20,13,12,5,15,80
2018-09-21,4,5,13,6,1,2,31
2018-09-22,7,1,13,14,11,3,49
2018-09-23,20,6,10,6,8,5,55
2018-09-24,8,4,13,14,17,4,60
2018-09-25,17,7,7,7,5,3,46
2018-09-26,1,5,8,17,3,9,43
2018-09-27,11,1,12,16,18,19,77
2018-09-28,4,1,3,19,14,13,54
2018-09-29,12,3,6,1,20,10,52
2018-09-30,1,14,1,8,14,12,50
2018-10-01,19,16,17,3,17,11,83
2018-10-02,1,10,14,7,10,18,60
2018-10-03,5,6,9,2,7,13,42
2018-10-04,8,9,17,10,11,2,57
2018-10-05,16,20,11,8,12,14,81
2018-10-06,7,19,20,5,6,12,69
2018-10-07,11,19,10,4,19,18,81
2018-10-08,19,14,4,11,15,10,73
2018-10-09,7,4,2,17,13,20,63
2018-10-10,19,18,12,20,13,6,88
2018-10-11,11,13,13,3,19,6,65
2018-10-12,13,3,1,11,19,13,60
2018-10-13,19,16,9,1,1,14,60
2018-10-14,9,8,16,12,12,9,66
2018-10-15,9,16,16,8,17,4,70
2018-10-16,16,9,19,12,16,4,76
2018-10-17,13,14,15,20,20,13,95
2018-10-18,20,8,14,4,10,4,60
2018-10-19,12,7,20,3,20,5,67
2018-10-20,8,9,9,13,5,20,64
2018-10-21,7,7,16,2,5,1,38
2018-10-22,12,1,11,3,20,15,62
2018-10-23,10,8,15,12,14,7,66
2018-10-24,12,2,11,20,12,11,68
2018-10-25,6,7,20,1,19,2,55
2018-10-26,14,16,11,20,1,13,75
2018-10-27,7,9,18,18,10,2,64
2018-10-28,19,5,13,1,20,12,70
2018-10-29,18,1,16,16,2,8,61
2018-10-30,12,5,14,8,16,16,71
2018-10-31,18,9,13,8,16,15,79
2018-11-01,16,19,19,13,12,15,94
2018-11-02,20,14,20,15,10,11,90
2018-11-03,19,4,4,8,15,17,67
2018-11-04,16,13,1,7,20,11,68
2018-11-05,13,15,20,13,16,19,96
2018-11-06,6,13,4,15,5,4,47
2018-11-07,9,7,11,10,1,13,51
2018-11-08,18,20,16,2,2,19,77
2018-11-09,2,11,13,10,7,1,44
2018-11-10,20,9,8,7,20,20,84
2018-11-11,7,9,6,18,7,5,52
2018-11-12,16,7,6,15,19,15,78
2018-11-13,8,12,19,10,14,15,78
2018-11-14,3,19,7,5,6,12,52
2018-11-15,11,9,5,13,17,4,59
2018-11-16,1,3,7,9,15,19,54
2018-11-17,16,20,17,11,16,10,90
2018-11-18,12,19,11,18,11,6,77
2018-11-19,2,18,20,11,3,9,63
2018-11-20,8,13,8,18,2,12,61
2018-11-21,10,1,16,15,7,4,53
2018-11-22,12,1,1,19,8,1,42
2018-11-23,1,3,3,20,10,15,52
2018-11-24,2,13,3,3,15,2,38
2018-11-25,4,6,14,11,2,7,44
2018-11-26,17,19,4,7,12,2,61
2018-11-27,20,6,20,16,5,8,75
2018-11-28,16,17,12,2,10,11,68
2018-11-29,6,16,17,4,8,12,63
2018-11-30,12,5,3,14,7,12,53
2018-12-01,1,2,5,10,11,5,34
2018-12-02,1,7,18,15,9,5,55
2018-12-03,10,7,8,16,5,19,65
2018-12-04,15,12,8,18,15,17,85
2018-12-05,8,15,12,17,3,6,61
2018-12-06,4,15,18,8,13,9,67
2018-12-07,16,1,18,8,14,9,66
2018-12-08,15,15,2,3,2,6,43
2018-12-09,14,20,2,12,9,5,62
2018-12-10,1,12,1,15,7,17,53
2018-12-11,19,17,6,16,14,17,89
2018-12-12,14,6,20,7,12,2,61
2018-12-13,18,20,10,18,9,20,95
2018-12-14,1,7,5,15,11,6,45
2018-12-15,19,1,3,8,9,4,44
2018-12-16,11,1,15,11,7,12,57
2018-12-17,7,3,12,16,15,9,62
2018-12-18,13,17,14,14,17,2,77
2018-12-19,15,16,4,18,3,19,75
2018-12-20,3,12,13,10,17,4,59
2018-12-21,20,11,19,8,3,15,76
2018-12-22,3,3,5,9,1,15,36
2018-12-23,12,13,7,11,5,20,68
2018-12-24,13,7,4,18,12,15,69
2018-12-25,16,15,6,15,14,20,86
2018-12-26,4,13,6,1,8,8,40
2018-12-27,15,20,3,2,19,11,70
2018-12-28,15,15,1,6,7,10,54
2018-12-29,9,12,20,4,2,2,49
2018-12-30,8,12,16,11,16,8,71
2018-12-31,1,13,8,5,8,1,36
2019-01-01,10,17,5,20,20,19,91
2019-01-02,14,17,11,9,15,1,67
2019-01-03,3,8,15,10,17,10,63
2019-01-04,1,15,2,8,16,19,61
2019-01-05,7,13,10,13,10,10,63
2019-01-06,14,15,5,2,16,15,67
2019-01-07,20,20,1,3,19,12,75
2019-01-08,9,2,15,16,5,5,52
2019-01-09,9,8,9,17,6,1,50
2019-01-10,18,4,12,16,8,19,77
2019-01-11,6,18,5,6,17,15,67
2019-01-12,5,18,4,14,2,5,48
2019-01-13,4,7,12,10,8,12,53
2019-01-14,4,14,9,12,14,20,73
2019-01-15,11,2,6,18,8,20,65
2019-01-16,5,9,3,13,4,16,50
2019-01-17,2,10,1,16,6,11,46
2019-01-18,17,17,7,7,5,6,59
2019-01-19,20,13,17,20,15,8,93
2019-01-20,10,8,3,20,18,5,64
2019-01-21,10,14,3,7,20,12,66
2019-01-22,7,15,7,12,13,3,57
2019-01-23,17,20,5,2,13,16,73
2019-01-24,14,7,2,12,11,17,63
2019-01-25,4,18,19,4,18,12,75
2019-01-26,6,12,20,19,9,18,84
2019-01-27,1,20,8,20,10,18,77
2019-01-28,1,8,9,19,4,19,60
2019-01-29,3,12,20,12,8,12,67
2019-01-30,16,8,8,20,10,16,78
2019-01-31,10,20,15,17,8,17,87
2019-02-01,11,17,1,10,17,4,60
2019-02-02,5,18,10,8,20,13,74
2019-02-03,20,15,1,2,16,1,55
2019-02-04,2,17,20,18,9,9,75
2019-02-05,6,4,5,13,2,6,36
2019-02-06,19,3,13,1,1,2,39
2019-02-07,20,1,20,12,10,5,68
2019-02-08,5,14,20,14,1,1,55
2019-02-09,14,19,5,9,20,1,68
2019-02-10,16,4,15,4,17,14,70
2019-02-11,19,10,14,18,6,7,74
2019-02-12,5,11,5,15,4,12,52
2019-02-13,3,10,18,5,8,19,63
2019-02-14,14,20,9,12,2,16,73
2019-02-15,3,13,10,2,17,4,49
2019-02-16,19,4,12,18,15,15,83
2019-02-17,12,19,5,2,16,15,69
2019-02-18,2,1,5,16,14,1,39
2019-02-19,14,6,4,19,2,2,47
2019-02-20,3,2,6,20,2,12,45
2019-02-21,17,1,5,9,11,1,44
2019-02-22,14,12,13,19,15,15,88
2019-02-23,8,13,1,3,12,18,55
2019-02-24,9,2,6,1,9,18,45
2019-02-25,12,12,17,7,10,15,73
2019-02-26,19,16,15,20,9,3,82
2019-02-27,8,13,18,18,18,9,84
2019-02-28,15,12,14,18,14,9,82
